122211121100000000000000035W5W5400000
1OOOV0000100000000004343F4T000T3F3433
2O0000000100000000003T0000000000000T4
10000000012211121112E00+00?00Q00=000E
2000000001000000000200000000000000003
#0000000000000000000000C0000C0000C004
2000000002000000000100000000000000004
100I00I0011220000111E000000000000000E
200000000200110011004T0000000000000T4
1000000001000200200033G3430000034G343
212X12Z122000100200000000311021100000
0022222200000200100000000010002000000
0000000000000100200000000020L02000000
0001111111110200100000000010002000000
0021020201021100200000000020001000000
0010000000001000100000000020002000000
00#0000000000000100000000010L01000000
001U000000001000200000000020001000000
0021010101021112100000000010002000000
0001111111110000000000000020002000000
0000000000000000000000000020L01000000
0000000000000000000000000010002000000
0000000000000000000001121211011111210
0000000000000000000002000010001000B20
000000000000000000000100S000L00000020
0000000000000000000001000010001000020
0000000000000000000002000020002000020
000000000000000000000112112A0A1111110
0000000000000000000001000010001000010
0000000000000000000002B00000L00D00020
0000000000000000000001000010001000010
0000000000000000000001221120002112110
0000000000000000000001000A00000A00010
000000000000000000000200L000L000L0010
00000000000000000000010000A00000A0010
0000000000000000000001#21#12$12#21#10
