122211121100000000000000035W5W5400000
100000000100000000004343F4000003F3433
2000000001000000000030000000000000004
10000000012211121112E000000000000000E
2000000001000000000200000000000000003
#000000000000000000000000000000000004
2000000002000000000100000000000000004
10000000011220000111E000000000000000E
2000000002001100110040000000000000004
1000000001000200200033G3430000034G343
2120120122000100200000000311021100000
0022222200000200100000000010002000000
0000000000000100200000000020002000000
0001111111110200100000000010002000000
0021020201021100200000000020001000000
0010000000001000100000000020002000000
00#0000000000000100000000010001000000
0010000000001000200000000020001000000
0021010101021112100000000010002000000
0001111111110000000000000020002000000
0000000000000000000000000020001000000
0000000000000000000000000010002000000
0000000000000000000001121211011111210
0000000000000000000002000010001000020
000000000000000000000100B000000000020
0000000000000000000001000010001000020
0000000000000000000002000020002000020
0000000000000000000001121120001111110
0000000000000000000001000010001000010
0000000000000000000002000000000000020
0000000000000000000001000010001000010
0000000000000000000001221120002112110
0000000000000000000001000000000000010
0000000000000000000002000000000000010
0000000000000000000001000000000000010
0000000000000000000001#21#12S12#21#10
