z111111112222222211112212344344334433343343333313334444434433311
2MM0002000MM2000002000001000000000000AAA3000003330000A0A00000331
10B-00200-0M200-00100-0B00030000000000AAE00P00E00003==A000000031
100L0010SL00100L0M100L00100300000003==**300000300003333333300031
2000002000002000002000001443444433333434330003443433434344343034
100000100M001000S01000002300000000030000000000000003000000000003
121011121011121021221012230L0000000000L0000L0000L000000000000L03
$000000000000000000000002000000000030000000000000003000000000003
1000000000000000000000001000033433333343333033344333444433300004
#00L00000L00000L00000L00000003AA0034?0000300030000?33000AA330033
10000000000000000000000010000FA0000E0-L0000L0000L-0E00000AFF00F1
#0000000000000000000000010000400000300=0030004000?+3000000330033
1110112110121210121210112300034433033433333E44333433034434300004
2000001000002000001000001300000000000000003E30003G30003F30000003
1000002000002B00002000002300000000000000000000000000000000000003
100L0010SL00100L00200LM0230L000000L00000000L00000000000000000L04
200-00200-00200-0020B-0013003E3000000000000000004G30004F30000003
10M00S1000001M00002000001333403440004F44F30003434034E34034333433
222121211212212211211221143333333404333333304343%%%%%%%%%%%%%%%%
33F443433433F434334334F4300000000000000000000003%=???=+0000000*%
30000000000000000000000040L0000000000000000L0003%?++?+?00000000%
300000000000000000000000300000000000000000000003%%%%%%%%%%%%%%0%
3000000000000000000000003000334433343343343333330000333433343%0%
40005555W5555555W55550003000440=0+0330000000433E3E43300000004%0%
30005AA==00+5000*0005000400030^=00^04000000040&0&0&030p0p0p03%0%
30005A0-0-0+500-0-0050003000300000003300000030000000400000003%0%
G00050000000500000005000G0004+00C0000000C0000000C0000000C0p04%0%
3000500-0-005?0-0-0?500030003+0?00003000000030000000300000003%0%
300050000000500000005000300030^0?0^04000000040&0&0&030p000p04%0%
30005555H5055505H5555000400033000?0430000000334E4E43300000003%0%
3000000000000000000000003000334344334333333330000000344303443%0%
40000000000000000000000030003443G4330000000000000000330000034%0%
300000000000000000000000300040-000-40000000000000000300000003%0%
3E0E34334334F443333344F34000300000030000000000000000400000003%0%
40003000000000000000000030L00000C00F00000000000000003000C0004%0%
30L040L0000000L0000000L04000300000030000000000000000400000003%0%
300040000000000000000000400040-000-400000000000000003_0000003%0%
3000300033333000333330004000300000040000000000000000430000033%0%
400040003?0?3000000030004000333303333000000033434434343303330%0%
3000300030L030000000300030003000000030000000300000OO300000033%0%
300030003000300000003000300030p000p0300000003Z00000O4000000K3%0%
4000300033033000434334033000300000003000000030000000300000043%0%
3000400000000000F000400040L00000C000300000003300C0000000C00K3%0%
300030L0000000L0300040003000300000003000000030000000300000033%0%
3000400000000000F3333000300030p000p0300000003X0000003000000K3%0%
3000433334434344330000L0E00030000000300000003000000033K4K3K33%0%
4000300000000000000030003000433334334034343433430343333433433%0%
300040000000000000004000400040000000403000oo30000003300000003%0%
300030000000000000003000300030000000344000oo4OO000V040J000j04%0%
3000300033433443443333033000300000003000000o3O000000300000003%0%
30004000300000000000000040L00000C0000000C0000000C0000000C0004%0%
4000300040L00000000000L04000300000004000000030000000300000003%0%
300030004000000000000000300030000V00334000433000000o400000o33%0%
30003+0+300033443303333340004000000o4030003043000000300000330%0%
300040+04000300000000000400034334434304343400333E334333303300%0%
30003+0+30004000000000003000300000003000000000000000434303434%0%
300030?03000300300000300400040I00SI030000000000000003*0000003%0%
30003?0?30003000000000003000300000003000000000000000300A000A4%0%
30004=?=3000000000L0000000L00000C0003000000000000000E03433333%0%
4000343340003000000000003000300000003000000000000000300000003%0%
300000003000400300000300430340I000I030000000000000003AA00330000%
F0L000L000L04000000000003*0*3000000030000000000000003334034033%%
40000000300030000000000033044333433330000000000000003*000000*301
4443344334334433334333343334111111111111111111111111333343333311
