5555555555555555555555555W55555W5555555555555555555555555555555
50000000000000000000005&000000000&50000000000000000033333300005
5000000000000000005555W00-00-00-00W343F44344330000003++AA300005
5000000000000000005?++5000000000005000000000040000033+=AA300005
500000000000000000W+00000000C000000000000000030000030==AA300005
5000000000000000005???50000000000050000000000400000300=AA300005
5000000000000000005555W00000000000H433F3330003033E34043E4300005
50000000000000000000005000000000005000000300030400?^0^?+0400005
5000000000000000000000555W550555555000034300043F0!0+000!0F00005
500000000000000000000000005000500000000300000004000000000300005
5000000000000000000000000050005000000003000000000000-000i400005
50000000000000000000000000H0L0H00000000300000003000000000300005
5000000000000000000000000050005000000003343E343F0!00000!=F34343
5000000000000000000000000050005000000000000000030000000==33OM04
5000000000000000000000005550005555550000000000034E33033E4340L03
5000000000000000000000005K00L0000005000000000000004000300030003
5000000000000000000000005550005550A500000000000000F0L0F00033034
500000000000000000000000005000505*A5000000000000004000334330003
500000000000000000000000005000505*05000000000000003000300040L03
50000000000000000000000000W0L0W0555500000000000000F0L0F0L000003
5000000000000000000000000050005000000000000000000030004?0030003
122211121100000000000000035W0W540000000000000003343303343430004
1OOOV000M100000000004343F4T000T3F3433000000000030000000003F0L0F
2O0000000100000000003T0000000000000T40000000000F0T00000T0430004
10000000012211121112E00+00?00Q00=000E0000000000300L000L00430003
200000000100000000020000000000000000300000000004000000000300003
#0000000000000000000000C0000C0000C0040000000000F000000000000003
200000000200000000010000000000000000400000000003000000000300003
100I0MI0011220000111E000000000000000E0000000000400L000L00330003
200000000200110011004T0000000000000T40000000000F0T00000T0330004
10M0000001000200200033G3430000034G34300000000003000000000330003
212X12Z122000100200000000311021100000000000000034433043343G0L0G
502222220000020010000000001000200000000000000000003000300040003
5000000000000100200000000020L0200000000000000000004000433330003
5001111111110200100000000010002000000000000000000030003o0030004
5021_2_2010211002000000000200010000000000000000000F0L0F0L000003
501000000000100010000000002000200000000000000000004000400040004
50#0000000000000100000000010L0100000000000000000004000334330004
501U0000000010002000000000200010000000434E343F44343000434340003
50210101010211121000000000100020000000F000000400000000000000004
500111111111000000000000002000200000003000000000L0000000L000004
5000000000000000000000000020L010000000F000000300000000000000003
50000000000000000000000000100020000000343E3403334333G3443443443
5000000000000000000001121211011111210000003M0000300F00000000005
5000000000000000000002000010001000B2000000340300300300000000005
500000000000000000000100S000L0000M02000000033300000F00000000005
500000000000000000000100001000100002000000000333303300000000005
500000000000000000000200002000200002000000000003003000000000005
500000000000000000000112112000111111000000000003003000000000005
500000000000000000000100001000100001000000000003333000000000005
5000000000000000000002B00M00L00D0P02000000000000000000000000005
500000000000000000000100001000100001000000000000000000000000005
500000000000000000000122112000211211000000000000000000000000005
500000000000000000000100000000000001000000000000000000000000005
5000000000000000000002A0L000L000L001000000000000000000000000005
500000000000000000000100000000000001000000000000000000000000005
5555555555555555555551#21#12$12#21#1555555555555555555555555555
