55555555555555555555555555555555555555W55H55W55H5555555555555555
500A00?0?0?00005555555555555555555555&00000000=0&500000000000005
50-0000?0?000-0500000000000000000000500000000000=500000000000005
500000000000000000L000L000L000L000L0H0000000000I0W00000000000005
50000-0000-0000500000000000000000000500000000000?500000000000005
500C00000000C005555555555555555550005&0000000000&500000000000005
50000-0000-000055W55H55W55H55W55500055W55H55W5505500000000000005
5000000000000005000000000000000000000000000000000500000000000005
50-00000+0000-0500L000L000L000L000L000L0000L000L0500000000000005
500A0*0+0+000005000000000000000000000000000000000500000000000005
55555555555555550000055H55W55H55W55H55W55H5H555H5500000000000005
55000005k55555b500000500==0+050000000000000^50AMA500000000000005
550000050L0A0L0500L005=!000!+500L000L000L00000055500000000000005
550o0005*I000I0W00000H0=000++W0000000000000^50AMA50043F4433F3305
55oo000500000005000005000000?50000055H55W55H55W555033A0MM00M0435
550o00050L000L05000005?000000500L0050000000000000044!0M0000MA!43
550000050I000I0H00L00W000-000H00000W000000000000004000-0000-0003
55000005000000050000050!000!050000050000000000000040000000000003
55000005000000050000050000000500000500000000000000F000000000000F
55550555555055555505555H505W555505550000000000000040000000000003
50000000000000000T0T00000000000000050000000000000044000000000043
500L00L00L00L00L00L00L00L00L00L00L0500000000000000434G304403G433
500000000000000000000000000000000005000000000000004000T0000T0004
500055W55H55W55555W55H55W55H55W55555H55555555W555340000000000003
5000000000000005000000000000000005000000000000005000000000000004
500L00L00L00L0000L00000L00000L000000000000000000000000000000000F
50^0^000000^0^050000000000000000050000000000000050000L000000L004
555055555555055555H55050005W55H55555H55555555W555330000044000004
550005555550005W55H500500050003334333344333433344330000043000003
5T000000^000000^0005A05101222240000000000000000000000L003F00L00F
H00000000000000?0^0WA51000200240L0000000000000000000000033000003
5==&0000000000?00005A5100010A23000000000000000000000000034000003
W=00000000000000?0?H52100010113303343443334333443330000044000003
50^00000000000^000^502K0L000A130000300000300000000300L004F00L00F
H00T000000000000000W02100021114M000333E3330000000000000034000003
50000?000000000??&0500100010003MM0O34A-0330000000030000033000003
555W55H55W55H55W55H500100010003333334AL0433333333333443433000003
533433444433344334333411011334443433300043433434333300000400L003
54OO00000000000??00OO3400033000s00s0340330000000003400?003000003
33M@0000M000O0000?0VO43000330S000000400030000000s0340?0000000004
4Z?0000M0000000V0000M3300034o000000000000000000000430IL000000003
34I0000000II_000000I0440L034000L000040L0300000L00034000000000004
3XM?0000000000000000M3400033S00000000000000000000033000003000004
333443033443333033433340003b000000003000300s0000s043000004000003
40o0o00o0Voo00o00o0o0330004I000000033000440000000033434333033433
3000000V0000000000000340L03334G44433T000T33443F34333333300000305
3k000000--00--000000k440003000000000000000000000003000330000p405
4000000000000000000004E0000000L000L000L000L000L00000L03300000305
3k-0000000000000000-k3400040000000000000000000000030003400L00305
30000000000MM00000000430L03433G400000000000003F34330003300000305
33303443433433343303434000400AA12121210112112140000000340000p405
30000000000000000000034000400AA200002000100MB14L0000003300000305
40-00-00-0000000-00-?430004000A200S000L0000001403333333334434305
3000000000000000000003F0L0F0000200002000200002000212111211100111
F0!000000000C000000!0G3000400001121210002112110002UU0100001111b1
3?000000000000000000033000400001000010001000010L01U001U00V1I_0U1
3A-00-00-0000000-00-A43000400002B00000000000020001101110111000V2
400000000000000000000330L0400+?1000M10L01000S1000100000000000001
33E30003E3300033000433400030+?=112112000211221000000000000000002
53333033433404434043G3300040?==2000020001000B10L0100000000000001
54b0000Vo33T0T00T0T0000000404442000M00L0000002000220112011200002
544000000330L000L000L000L0000402B00020001M00010P01000100_0100002
53b0000Vo44000000000000000444401212110002121211111000100001V0001
54333433434433333444G44444355555555512#1155555555111211221122121
