555555555555555555555
5H0000000000pTIOIZXK5
500000000000000000005
5%0000000000000VkUBS5
500000000000000000005
5F0000000000000000005
500000000000000000005
5G0000000000000000005
500000000000000000005
5$00=0000000000000005
5000Q0000000000000005
5#00A0000000000000005
5000A0000000000000005
5200A000000000000P005
5000+0000000000000005
5100?0000000000000005
500000000000000000005
530000000000000000005
500000000000000000005
5400M0000000000000005
500000000000000000005
5E00*00000000000sDCL5
500000000000000000005
5W00_000000jJboi!^-&5
555555555555555555555