333333333333333333333
300000000000000000003
300000000000000000003
300000000000000000003
300000000000000000003
300000000000000000003
300000000000000000003
300000000000000000003
300000000000000000003
300000000000000000003
300000000000000000003
300000000000000000003
3000000000000000P0003
300000000000000000003
333333333333333333333