333333333333333333333
3%00_0000000pTIOIZXK3
3F00*0000000000VkUBS3
3G00M0000000000000003
3$0000000000000000003
3#00=0000000000000003
3200Q0000000000000003
3100A000000000000P003
3300+0000000000000003
3400?0000000000000003
3E0000000000000000003
3500M0000000000000003
3W00*00000000000sDCL3
3H00_000000jJboi!^-&3
333333333333333333333