555555555555555555555
5%0000000000pTIOIZXK5
500000000000000000005
5F0000000000000VkUBS5
500000000000000000005
5G00_0000000000000005
5000*0000000000000005
5$00M0000000000000005
500000000000000000005
5#00=0000000000000005
5000Q0000000000000005
5200A000000000000P005
5000+0000000000000005
5100?0000000000000005
500000000000000000005
5300M0000000000000005
5000*0000000000000005
5400_0000000000000005
500000000000000000005
5E00000000000000sDCL5
500000000000000000005
55000000000jJboi!^-&5
555555555555555555555